ITとは？
IT→情報を取得して加工して保存してデータベースに転送するための科学技術である。

OS
OS→機器の基本的な管理や制御のための機能や多くのソフトウェアが共通して利用し、システム全体を管理することのできるソフトウェア
Windows→マイクロソフト社が開発、販売しているコンピュータのオペレーティングシステムである。
macOS (Mac OS X)→アップル社がMacシリーズ向けに提供しているOS製品のことである。
UNIX→1969年にAT&T社ベル研究所で開発が始まった、コンピュータ用のマルチタスク・マルチユーザーのOSの一種
Linux→オープンソースのオペレーティングシステムでプログラミングが公開されており、だれでも自由に入手や使用や改変することが出来るOSである。

言語・環境
HTML→Webページを記述するためのマークアップ言語
CSS→Webページのスタイルを指定するための言語
MySQL→世界中の多くの企業が使用しているデータベース管理システムのことである。
PHP→→サーバーサイドで動的なWebページ作成をするための機能を多く備えている特徴がある。
JavaScript→ブラウザ上でWebページをダイナミックに動かすことのできる簡単なプログラミング言語
jQuery→Webページ上で動作するJavaScriptライブラリの一つでブラウザの種類に限らず簡潔な記述で豊富な機能を活用することのできる言語である。
Apache→世界的に最も普及しているWebサーバーソフトウェアの一つでオープンソースソフトウェアとして公開している。
Bootstrap→HTML、CSS、JavaScriptで構成されたオープンソースのツールキットである。Sassの変数とミックスイン、レスポンシブなグリッドシステム、豊富なコンポーネント、jQueryベースのパワフルなプラグインでアイデアを形にすることのできる言語である。

エンジニアなど
SE→情報システムの企画、設計、開発、試験、構築、導入などに携わる技術者の総称のこと
PG→プログラミング言語やソフトウェア開発ツールなどを用いてコンピュータプログラムを作成、修正する技術者のことである。
Webデザイナー→Webに関係するデザイナーであり、企業や個人などのクライアントから依頼されたWebサイトのデザインを担当することである。

ユーザーインターフェース
CUI→コンピュータやソフトウェアが利用者に情報を開示したり操作を受け取ったりする方法の一つである。
GUI→コンピュータのディスプレイ画面上でアイコンや画像を多用し、マウスなどのポインティングデバイスによる直感的な操作を可能にするユーザーインターフェースのこと。

ファイルとディレクトリ
ファイル→コンピュータでデータを扱いやすくするための仕組み
ディレクトリ→電話帳、住所録、名鑑、要覧、指導書、規則集などの意味を持つ英単語のことで、IT関連では、多数の対象をその所在などの情報と共に一覧できるよう整理したものを意味することが多い
ルート・ディレクトリ→コンピュータがストレージ(外部記憶装置)の内容を整理するファイルシステムにおいて、装置やシステム全体の最上位のディレクトリのこと
カレント・ディレクトリ→実行中のソフトウェアなどがストレージ（外部記憶装置）の ファイルシステム 中で現在位置として指し示している ディレクトリ のこと
パス→コンピュータ内で特定の資源の所在を表す文字列のこと
絶対パス→HTMｌにおいてURLでページを指定して目的地となる情報がどこにあるかを確実に伝えること
相対パス→今いる階層を基準にして目的地となる情報がどこにあるかを伝えること

各種プロトコル
HTTP→WebサーバーとWebクライアントの間でデータの送受信を行うために用いられるプロトコルでWebページを構成するHTMLファイルやページに関連づけられたスタイルシート、スクリプト、画像、音声、動画などのファイルをデータ形式などのメタ情報を含めてやり取りすることができる。
FTP→インターネットなどのTCP/IPネットワークでファイル転送を行うことのできるプロトコルの一つ。
HTTPS→HTTPによる通信をより安全に行うためのプロトコルおよびURIスキームである。
SSL→インターネットなどのIPネットワークでデータを暗号化して送受信するプロトコルの一つ。
SSH→主にUNIXコンピュータで利用されるネットワークを介して別のコンピュータにログインして操作するためのソフトウェアの一で通信経路が暗号化されているためインターネット等を経由しても安全にアクセスすることができる。
ポート、ポート番号→インターネットで標準的に用いられるプロトコル(通信規約)であるTCP/IPにおいて、同じコンピュータ内で動作する複数のソフトウェアのどれが通信するかを指定するための番号のこと
HTTP、FTP、SSHの各ポート番号→80,21,22
ファイアウォール→ネットワークの境界に設置され、内外の通信を中継・監視し、外部の攻撃から内部を保護するためのソフトウェアや機器、システムなどのこと
TCP→インターネットなどのネットワークで、IP(Internet Protocol)の一段階上位層のプロトコル(通信規約)として標準的に使われるものの一つ

IPアドレス
IPアドレス→インターネットなどのTCP/IPネットワークに接続されたコンピュータや通信機器の一台ごとに割り当てられた識別番号である
グローバルIPアドレス→インターネットで相手と通信するために持つ、ほかのアドレスと重複しない一意のIPアドレスのこと
プライベートIPアドレス→LANなどの企業ネットワークに存在する端末が自由に使用できるIPアドレスのことである。

ドメイン
ドメイン→インターネットなどのTCP/IPネットワーク上で機器やネットワークを識別すること
DNS→インターネットなどのIPネットワーク上でドメイン名とIPアドレスの対応関係を管理するシステムのこと
VPN→通信事業者の公衆回線を経由して構築された仮想的な組織内ネットワークのこと
ブリッジ→複数のネットワークセグメントを結ぶ中継機器のうち、受信したデータのMACアドレスなどデータリンク層の宛先情報を参照して中継の可否を判断する機能をもったものである。
プロキシサーバー→コンピュータに代わってインターネットに接続し、サイトへアクセスするサーバーのこと

電子メール
SMTP→インターネットなどのTCP/IPネットワークで標準的に用いられる電子メールを伝送するための通信手順の一つ
POP→利用者が自分宛ての電子メールを保管しているメールサーバーにアクセスすることのできる通信規約である
IMAP→届いたメールをメールサーバ上にメールアドレスごとに設けられた専用の保存領域で管理する。利用者はサーバからメールの一覧を取得して必要な物を選択し、手元のコンピュータにダウンロードして閲覧する。

セッションとクッキー
セッション→通信に先立って、2台のホスト間で必要なデータをやり取りすること
クッキー→Webサイトの提供者が、Webブラウザを通じて 訪問者 のコンピュータに一時的にデータを書き込んで保存させる仕組み。
キャッシュ→低速な記憶装置や伝送路から読み出したデータのうち、直近に読み込んだものや使用頻度が高いものを高速な記憶装置に複製しておくこと

DB（データベース）について
チューニング→楽器の音の高さの調律・調弦や、無線通信や放送などで、受信したいチャンネルの電波周波数に機器を同調させる操作
スロークエリ→データベースにおいて、時間のかかっているSQL(遅いSQL)のこと
インデックス→多数のものの中から特定の対象をすばやく見つけ出すため識別情報や、 整列 された所在情報の一覧など

テストについて
フロー→コンピュータプログラムを構成する命令や手続き、処理の流れなどのこと
単体テスト→ソフトウェアやシステムのテスト手法の一つで、単一の部品(モジュール)を対象に行うテスト
結合テスト→開発中のソフトウェアのテスト手法の一つで、複数のモジュール(部品)を組み合わせて行うテスト。個々のモジュールの単体テスト後に行う

チケット管理ツール
チケット管理ツール→ プロジェクト毎に発生する各種タスクを発行して、制作者に対して仕事を依頼するためのもの
タスク→コンピュータで処理されるべき仕事

バージョン管理
Git→分散バージョン管理システムに分類され、管理するデータの集合体
SourceTree→ソースコード管理ツールGitの一つ
SVN→複数の開発者が共同で一つのソフトウェアを開発する際などに、ソースコードやドキュメントを管理するのに用いられるオープンソースのバージョン管理システムの一つである。
コンフリクト→複数の装置やプログラムなどが同じ資源を同時に利用しようとして競合状態になってしまうこと
デグレ→新しいバージョンのソフトウェアの品質が、以前より悪くなることや以前修正した不具合やバグが再発、復活すること
マージツール→フォルダとファイル両方が比較でき、理解しやすく扱いやすいテキスト形式で差異をビジュアルに表現します。